good_ingot=iron_ingot
bad_ingot=ur_mom
vedal=vedal
turtle=vedal
hello=vedal
omg_no_way=vedal
slimeball=slime_ball
cheese=sponge
my_brain=bucket
angry=angry_ingot@emoji
bangbang=bangbang_ingot@emoji
blob=blob_ingot@emoji
copper=copper_ingot@emoji
face_with_raised_eyebrow=face_with_raised_eyebrow_ingot@emoji
flushed=flushed_ingot@emoji
gold=gold_ingot@emoji
iron=iron_ingot@emoji
italics_thinking=italics_thinking_ingot@emoji
kissing_closed_eyes=kissing_closed_eyes_ingot@emoji
kissing=kissing_ingot@emoji
kissing_smiling_eyes=kissing_smiling_eyes_ingot@emoji
man_scientist=man_scientist_ingot@emoji
melting_face=melting_face_ingot@emoji
moyai=moyai_ingot@emoji
netherite=netherite_ingot@emoji
neutral=neutral_ingot@emoji
partying=partying_ingot@emoji
pensive=pensive_ingot@emoji
pog=pog_ingot@emoji
realistic_sus=realistic_sus_ingot@emoji
sick=sick_ingot@emoji
slight_frown=slight_frown_ingot@emoji
slight_smile=slight_smile_ingot@emoji
smirk=smirk_ingot@emoji
sob=sob_ingot@emoji
sob_sunglasses=sob_sunglasses_ingot@emoji
sunglasses=sunglasses_ingot@emoji
thinking=thinking_ingot@emoji
woozy=woozy_ingot@emoji
yum=yum_ingot@emoji